#############################################################################
#   +    +    +    +    +    +    +    +    +    +    +    +    +    +    + #
#                                                                           #
#                                                                       #####
#   +    +    +    +    +    +    +    +    +    +    +    +    +    +  ##+##
#                                                                       #####
#                                                                  #####    #
#   +    +    +    +  ################################+    +    +  ##+##  + #
#                     ################################             #####    #
#                     ################################        #####     #####
#   +    +    +    +  ################################+    +  ##+##  +  ##+##
#                     ################################        #####     #####
#                     ################################   #####     #####    #
#   +    +    +    +  ################################+  ##+##  +  ##+##  + #
#                                                        #####     #####    #
#                                                   #####     #####     #####
#   +    +    +    +    +    +    +    +    +    +  ##+##  +  ##+##  +  ##+##
#                                                   #####     #####     #####
#                                              #####     #####     #####    #
#############################################################################
